tab	补全
ctrl+a	移到命令行首
ctrl+e	移到命令行尾
-------------------------------------------
ctrl+k	从光标处删除至命令行尾
ctrl+u	从光标处删除至命令行首
Alt+d 	从光标处删除至字尾
ctrl+d	删除光标处的字符
ctrl+h	删除光标前的字符
alt+d	删除当前光标到临近右边单词开始
ctrl+w	删除此处到左边的单词
ctrl+d	关闭终端
-------------------------------------------
ctrl+y	粘贴由ctrl+u，ctrl+d，ctrl+w删除的单词(粘贴至光标后)
alt+.	粘帖最后一次命令最后的参数
-------------------------------------------
ctrl+p	向上显示缓存命令
ctrl+n	向下显示缓存命令
-------------------------------------------
Alt+t	swap(当前单词, 上一个单词)
Ctrl+t 	swap(当前字母, 上一个字母)
-------------------------------------------
ctrl+f	按字符前移（右向）
ctrl+b	按字符后移（左向）
Alt+f 	按单词前移（右向）
Alt+b 	按单词后移（左向）
Ctrl+xx 在命令行首和光标之间移动
-------------------------------------------
zsh:
[esc] [esc]

ctrl+n	向下移动
ctrl+p	向上移动
-------------------------------------------
ctrl+l	相当于clear
ctrl+c	终止

